.......BBBBBBBBBBBBBBBBBBBBBBBBBBBBBBBBBBBBBBBBBBBBBBBBBBBBBBBBBBBBBBBBBBBBBBBBBBBBBBBBBBBBBBBBBBBBBBBBBBBBBBBBBBBBBBBBBBBBBBBBBBBBBBBBBBBBBBBBBBBBBBBBBBBBBBBBBBBBBBBBBBBBBBBBBBBBBBBBBBBBBBBBBBBBBBBBBBBBBBBBBBBBBBBBBBBBBBBBBBBBBBBBBBBBBBBBBBBBBBBBBBBBBBBBBBBBBBBBBBBBBBBBBBBBBBBBBBBBBBBBBBB.
.......BBBBBBBBBBBBBBBBBBBBBBBBBBBBBBBBBBBBBBBBBBBBBBBBBBBBBBBBBBBBBBBBBBBBBBBBBBBBBBBBBBBBBBBBBBBBBBBBBBBBBBBBBBBBBBBBBBBBBBBBBBBBBBBBBBBBBBBBBBBBBBBBBBBBBBBBBBBBBBBBBBBBBBBBBBBBBBBBBBBBBBBBBBBBBBBBBBBBBBBBBBBBBBBBBBBBBBBBBBBBBBBBBBBBBBBBBBBBBBBBBBBBBBBBBBBBBBBBBBBBBBBBBBBBBBBBBBBBBBBBBBB.
.......BBBBBBBBBBBBBBBBBBBBBBBBBBBBBBBBBBBBBBBBBBBBBBBBBBBBBBBBBBBBBBBBBBBBBBBBBBBBBBBBBBBBBBBBBBBBBBBBBBBBBBBBBBBBBBBBBBBBBBBBBBBBBBBBBBBBBBBBBBBBBBBBBBBBBBBBBBBBBBBBBBBBBBBBBBBBBBBBBBBBBBBBBBBBBBBBBBBBBBBBBBBBBBBBBBBBBBBBBBBBBBBBBBBBBBBBBBBBBBBBBBBBBBBBBBBBBBBBBBBBBBBBBBBBBBBBBBBBBBBBBBB.
.......BBBBBBBBBBBBBBBBBBBBBBBBBBBBBBBBBBBBBBBBBBBBBBBBBBBBBBBBBBBBBBBBBBBBBBBBBBBBBBBBBBBBBBBBBBBBBBBBBBBBBBBBBBBBBBBBBBBBBBBBBBBBBBBBBBBBBBBBBBBBBBBBBBBBBBBBBBBBBBBBBBBBBBBBBBBBBBBBBBBBBBBBBBBBBBBBBBBBBBBBBBBBBBBBBBBBBBBBBBBBBBBBBBBBBBBBBBBBBBBBBBBBBBBBBBBBBBBBBBBBBBBBBBBBBBBBBBBBBBBBBBB.
.......BBBBBBBBBBBBBBBBBBBBBBBBBBBBBBBBBBBBBBBBBBBBBBBBBBBBBBBBBBBBBBBBBBBBBBBBBBBBBBBBBBBBBBBBBBBBBBBBBBBBBBBBBBBBBBBBBBBBBBBBBBBBBBBBBBBBBBBBBBBBBBBBBBBBBBBBBBBBBBBBBBBBBBBBBBBBBBBBBBBBBBBBBBBBBBBBBBBBBBBBBBBBBBBBBBBBBBBBBBBBBBBBBBBBBBBBBBBBBBBBBBBBBBBBBBBBBBBBBBBBBBBBBBBBBBBBBBBBBBBBBBB.
.......BBBBBBBBBBBBBBBBBBBBBBBBBBBBBBBBBBBBBBBBBBBBBBBBBBBBBBBBBBBBBBBBBBBBBBBBBBBBBBBBBBBBBBBBBBBBBBBBBBBBBBBBBBBBBBBBBBBBBBBBBBBBBBBBBBBBBBBBBBBBBBBBBBBBBBBBBBBBBBBBBBBBBBBBBBBBBBBBBBBBBBBBBBBBBBBBBBBBBBBBBBBBBBBBBBBBBBBBBBBBBBBBBBBBBBBBBBBBBBBBBBBBBBBBBBBBBBBBBBBBBBBBBBBBBBBBBBBBBBBBBBB.
.......BBBBBBBBBBBBBBBBBBBBBBBBBBBBBBBBBBBBBBBBBBBBBBBBBBBBBBBBBBBBBBBBBBBBBBBBBBBBBBBBBBBBBBBBBBBBBBBBBBBBBBBBBBBBBBBBBBBBBBBBBBBBBBBBBBBBBBBBBBBBBBBBBBBBBBBBBBBBBBBBBBBBBBBBBBBBBBBBBBBBBBBBBBBBBBBBBBBBBBBBBBBBBBBBBBBBBBBBBBBBBBBBBBBBBBBBBBBBBBBBBBBBBBBBBBBBBBBBBBBBBBBBBBBBBBBBBBBBBBBBBBB.
.......BBBBBBBBBBBBBBBBBBBBBBBBBBBBBBBBBBBBBBBBBBBBBBBBBBBBBBBBBBBBBBBBBBBBBBBBBBBBBBBBBBBBBBBBBBBBBBBBBBBBBBBBBBBBBBBBBBBBBBBBBBBBBBBBBBBBBBBBBBBBBBBBBBBBBBBBBBBBBBBBBBBBBBBBBBBBBBBBBBBBBBBBBBBBBBBBBBBBBBBBBBBBBBBBBBBBBBBBBBBBBBBBBBBBBBBBBBBBBBBBBBBBBBBBBBBBBBBBBBBBBBBBBBBBBBBBBBBBBBBBBBB.
.......BBBBBBBBBBBBBBBBBBBBBBBBBBBBBBBBBBBBBBBBBBBBBBBBBBBBBBBBBBBBBBBBBBBBBBBBBBBBBBBBBBBBBBBBBBBBBBBBBBBBBBBBBBBBBBBBBBBBBBBBBBBBBBBBBBBBBBBBBBBBBBB................................................BBBBBBBBBBBBBBBBBBBBBBBBBBBBBBBBBBBBBBBBBBBBBBBBBBBBBBBBBBBBBBB..............................
.......BBBBBBBBBBBBBBBBBBBBBBBBBBBBBBBBBBBBBBBBBBBBBBBBBBBBBBBBBBBBBBBBBBBBBBBBBBBBBBBBBBBBBBBBBBBBBBBBBBBBBBBBBBBBBBBBBBBBBBBBBBBBBBBBBBBBBBBBBBBBBBB................................................BBBBBBBBBBBBBBBBBBBBBBBBBBBBBBBBBBBBBBBBBBBBBBBBBBBBBBBBBBBBBBB..............................
.......BBBBBBBBBBBBBBBBBBBBBBBBBBBBBBBBBBBBBBBBBBBBBBBBBBBBBBBBBBBBBBBBBBBBBBBBBBBBBBBBBBBBBBBBBBBBBBBBBBBBBBBBBBBBBBBBBBBBBBBBBBBBBBBBBBBBBBBBBBBBBBB................................................BBBBBBBBBBBBBBBBBBBBBBBBBBBBBBBBBBBBBBBBBBBBBBBBBBBBBBBBBBBBBBB..............................
.......BBBBBBBBBBBBBBBBBBBBBBBBBBBBBBBBBBBBBBB.........BBBBBBBBBBBB...BBBBBBBBBBBBBBBBBBBBBBBBBBBBBBBBBBBBBBBBBBBBBBBBBBBBBBBBBBBBBBBBBBBBBBBBBBBBBBBB................................................BBBBBBBBBBBBBBBBBBBBBBBBB................BBBBBBBBBBBBBBBBBBBBBB..............................
.......BBBBBBBBBBBBBBBBBBBBBBBBBBBBBBBBBBBBB.............BBBBBBBBBB...BBBBBBBBBBBBBBBBBBBBBBBBBBBBBBBBBBBBBBBBBBBBBBBBBBBBBBBBBBBBBBBBBBBBBBBBBBBBBBBB................................................BBBBBBBBBBBBBBBBBBBBBBB..........ooo.......BBBBBBBBBBBBBBBBBBBB..............................
.......BBBBBBBBBBBBBBBBBBBBBBBBBBBBBBBBBBB.........@.......BBBBBBBB...BBBBBBBBBBBBBBBBBBBBBBBBBBBBBBBBBBBBBBBBBBBBBBBBBBBBBBBBBBBBBBBBBBBBBBBBBBBBBBBB................................................BBBBBBBBBBBBBBBBBBBBB............ooo.........BBBBBBBBBBBBBBBBBB..............................
.......BBBBBBBBBBBBBBB...........................o...o.......BBBBBB...BBBBBBBBBBBBBBBBBBBBBBBBBBBBBBBBBBBBBBBBBBBBBBBBBBBBBBBBBBBBBBBBBBBBBBBBBBBBBBBB................................................BBBBBBBBBBBBBBBBBBB..............ooo...........BBBBBBBBBBBBBBBB..............................
.......BBBBBBBBBBBB.............................o.....o............?..BBBBBBBBBBBBBBBBBBBBBBBBBBBBBBBBBBBBBBBBBBBBBBBBBBBBBBBBBBBBBBBBBBBBBBBBBBBBBBBB................................................BBBBBBBBBBBBBBBBB................................BBBBBBBBBBBBBB..............................
.......BBBBBBBBB...........................................................BBBBBBBBBBBBBBBBBBBBBBBBBBBBBBBBBBBBBB............................BBBBBBBBB................................................BBBBBBBBBBBBBBB............o.......................BBBBBBBBBBBB..............................
.......BBBBBB...................o............................................BBBBBBBBBBBBBBBBBBBBBBBBBBBBBBBBBB..............................BBBBBBBBB........................ooo...............................................o.ppppppppppppp............BBBBBBBBBB..............................
.......BBB.....................o.======ppp======...............................BBBBBBBBBBBBBBBBBBBBBBBBBBBBBB................................BBBBBBBBB........................ooo............................................................................BBBBBBBB..............................
.................................BBBBBB...BBBBBB.......=======pppppppp===........BBBBBBBBBBBBBBBBBBBBBBBBBB..................................BBBBBBBBB........................ooo..............................................................................BBBBBB..............................
.................................BBBBBB...BBBBBB.......BBBBBBB........BBB..........BBBBBBBBBBBBBBBBBBBBBB....................................BB.ooo.BB...................................####.........===============............................................BBBB..............................
.................................BBBBBB...BBBBBB.......BBBBBBB........BBB==..................................................................BB.o@o.BB...........................................pppppBBBBBBBBBBBBBBB.....o.ppppp...............ppppp..............BB..............................
........................o.=====..BBBBBB...BBBBBB.......BBBBBBB........BBBBB.............................................................o....BB.ooo.BB.......................##?##.......................................o........................................................................
.......................o..BBBBB..BBBBBB...BBBBBB......................BBBBB...........................................................o...o..BB.....BB.............................................................................................................................................
..........................BBBBB.......................................BBBBB....................................................o?o...o.....o.BB.....BB..................................======.....................................................................................................
========..................BBBBB...........................................................o..................................................BB#####BB..................................BBBBBB...==================...pppp.............................pppp.........=..............................
BBBBBBBB..............==..BBBBB?..........oo...........========.........................o...o............o...o...............................BB#####BB....................ppppppppppp...BBBBBBpppBBBBBBBBBBBBBBBBBB................................................=B..............................
BBBBBBBB............==BB..................oo..........=BBBBBBBB........................o.....o..........o.....o....===..ppp=====p=====..........................................................................................................ppp...............=BB..............................
BBBBBBBB..........==BBBB.............................=BBBBBBBBB...................................................=BBB.....BBBBB.BBBBB..........................................................................................................o@o..............=BBB..............................
BBBBBBBB........==BBBBBB............................=BBBBBBBBBB..................................................=BBBB.....BBBBBuBBBBB......c...................................................................................................................=BBBB......z.......T.... ..........
BBBBBBBB......==BBBBBBBB....=======.....======.....=BBBBBBBBBBB................=========.....============.....===BBBBB.....BBBBBmBBBBB.....====ppppp==...=...=...==ppupp==...=...=...==ppppupppppup=========================....................===..........===BBBBB=============================.
BBBBBBBB......BBBBBBBBBB....BBBBBBB.....BBBBBB.....BBBBBBBBBBBB.......======...BBBBBBBBB.....BBBBBBBBBBBB.....BBBBBBBB....uBBBBBmBBBBB.....BBBB.....BB...B...B...BB..m..BB...B...B...BB....m.....m.BBBBBBBBBBBBBBBBBBBBBBBBB....................BBB..........BBBBBBBBBBBBBBBBBBBBBBBBBBBBBBBBBBBBB.
BBBBBBBB......BBBBBBBBBB....BBBBBBB.....BBBBBB.....BBBBBBBBBBBB.......BBBBBB...BBBBBBBBB.....BBBBBBBBBBBB.....BBBBBBBB....mBBBBBmBBBBB.....BBBB.....BB...B...B...BB..m..BB...B...B...BB....m.....m.BBBBBBBBBBBBBBBBBBBBBBBBB....................BBB..........BBBBBBBBBBBBBBBBBBBBBBBBBBBBBBBBBBBBB.
BBBBBBBBLLLLLLBBBBBBBBBBLLLLBBBBBBBLLLLLBBBBBBLLLLLBBBBBBBBBBBBLLLLLLLBBBBBBLLLBBBBBBBBBLLLLLBBBBBBBBBBBBLLLLLBBBBBBBBLLLLmBBBBBmBBBBBLLLLLBBBBLLLLLBBLLLBLLLBLLLBBLLmLLBBLLLBLLLBLLLBBLLLLmLLLLLmLBBBBBBBBBBBBBBBBBBBBBBBBBLLLLLLLLLLLLLLLLLLLLBBBLLLLLLLLLLBBBBBBBBBBBBBBBBBBBBBBBBBBBBBBBBBBBBB.
BBBBBBBBLLLLLLBBBBBBBBBBLLLLBBBBBBBLLLLLBBBBBBLLLLLBBBBBBBBBBBBLLLLLLLBBBBBBLLLBBBBBBBBBLLLLLBBBBBBBBBBBBLLLLLBBBBBBBBLLLLmBBBBBmBBBBBLLLLLBBBBLLLLLBBLLLBLLLBLLLBBLLmLLBBLLLBLLLBLLLBBLLLLmLLLLLmLBBBBBBBBBBBBBBBBBBBBBBBBBLLLLLLLLLLLLLLLLLLLLBBBLLLLLLLLLLBBBBBBBBBBBBBBBBBBBBBBBBBBBBBBBBBBBBB.
